{
  "level": [
    [2, 2, 2, 1, 2, 0, 0, 0, 0, 0],
    [2, 2, 2, 0, 2, 0, 2, 0, 2, 0],
    [0, 0, 0, 0, 2, 0, 2, 3, 2, 0],
    [2, 2, 2, 0, 2, 0, 2, 2, 2, 0],
    [0, 0, 0, 0, 0, 0, 0, 0, 0, 0],
    [0, 2, 0, 0, 2, 2, 2, 2, 2, 2],
    [0, 2, 0, 0, 2, 2, 2, 2, 2, 2],
    [0, 2, 0, 0, 2, 2, 2, 2, 2, 2]
  ],
  "entities": [
    {"id": 1, "x": 0, "y": 7},
    {"id": 2, "x": 4, "y": 4}
  ]
}
