{
	"level": [
		[0, 0, 0, 2, 0, 0, 0, 0, 0, 0],
		[0, 2, 0, 2, 0, 2, 2, 0, 2, 2],
		[0, 2, 0, 2, 0, 2, 0, 0, 0, 0],
		[0, 2, 0, 2, 0, 2, 2, 2, 2, 0],
		[0, 2, 0, 2, 0, 2, 0, 0, 0, 0],
		[0, 2, 0, 0, 0, 2, 2, 0, 2, 2],
		[0, 2, 2, 2, 2, 2, 2, 1, 2, 2],
		[0, 0, 0, 0, 0, 2, 2, 2, 2, 2]
	],
	"entities": [
		{"id": 0, "x": 4, "y": 7}
	]
}
