{
	"level": [
		[0, 0, 0, 2, 0, 0, 0, 0, 0, 0],
		[0, 2, 0, 2, 0, 2, 2, 0, 2, 2],
		[0, 2, 0, 2, 0, 2, 0, 0, 0, 0],
		[0, 2, 0, 2, 0, 2, 2, 2, 2, 0],
		[0, 2, 0, 2, 0, 2, 0, 0, 0, 0],
		[0, 2, 0, 0, 0, 2, 2, 0, 2, 2],
		[0, 2, 2, 2, 2, 2, 2, 0, 2, 2],
		[0, 0, 0, 0, 1, 2, 2, 2, 2, 2]
	],
	"entities": [
		{"x": 7, "y": 6, "id": 0}
	]
}
