[
    [5, 0, 0, 5, 5, 5, 5, 0, 5, 5, 5, 5, 5, 5, 5, 5, 5, 5, 5, 5, 5, 5, 5, 5, 5, 5, 5, 5, 5, 5, 5, 5, 5, 5, 5, 5, 5, 5, 5, 5],
	[5, 5, 5, 5, 0, 0, 5, 5, 5, 0, 0, 0, 0, 0, 0, 0, 0, 0, 0, 0, 0, 0, 0, 0, 0, 0, 5, 5, 5, 5, 0, 0, 5, 5, 5, 5, 5, 5, 5, 5],
	[0, 5, 0, 0, 0, 0, 1, 1, 1, 1, 1, 1, 1, 1, 1, 1, 1, 1, 1, 1, 1, 1, 1, 1, 1, 1, 1, 1, 1, 1, 1, 1, 0, 0, 5, 5, 5, 5, 5, 5],
	[0, 5, 0, 0, 0, 0, 1, 4, 4, 4, 4, 4, 4, 4, 4, 1, 4, 4, 4, 4, 4, 4, 4, 1, 4, 4, 4, 4, 4, 4, 4, 1, 0, 0, 0, 0, 0, 0, 5, 5],
	[1, 1, 1, 1, 1, 1, 1, 4, 4, 4, 4, 4, 4, 4, 4, 1, 4, 4, 4, 4, 4, 4, 4, 1, 4, 4, 4, 4, 4, 4, 4, 1, 1, 1, 1, 1, 1, 1, 1, 1],
	[1, 1, 1, 1, 1, 1, 1, 4, 4, 4, 4, 4, 4, 4, 4, 1, 4, 4, 4, 4, 4, 4, 4, 1, 4, 4, 4, 4, 4, 4, 4, 1, 1, 1, 1, 1, 1, 1, 1, 1],
	[1, 1, 5, 5, 5, 5, 1, 4,42,43, 4, 4, 4, 4, 4, 1, 4,42,43, 4, 4, 4, 4, 1, 4,42,43, 4, 4, 4, 4, 1,42,43,14,15,16,42,43, 1],
	[1, 1, 5, 5, 5, 5, 1, 1, 1, 1, 1, 1, 1, 4, 1, 1, 1, 1, 1, 1, 1, 6, 1, 1, 1, 1, 1, 1, 1, 6, 1, 1, 4, 4, 4,15, 4, 4, 4, 1],
	[1, 1, 5, 0, 0, 5, 1, 4, 4, 4, 4, 4, 4, 4, 4,14,15,15,16, 4, 4, 4, 4, 4, 4, 4, 4, 4, 4, 4, 4, 4, 4, 4, 4, 4, 4, 4, 4, 1],
	[1, 1, 0, 0, 5, 5, 1, 4, 4, 4, 4, 4, 4, 4, 4, 4, 4, 4, 4, 4, 4, 4, 4, 4, 4, 4, 4, 4, 4, 4, 4, 4, 4, 4, 4, 4, 4, 4, 4, 1],
	[1, 1, 0, 5, 5, 5, 1, 4, 4, 4, 4, 4, 4, 4, 4, 4, 4, 4, 4, 4, 4, 4, 4, 4, 4, 4, 4, 4, 4, 4, 4, 4, 4, 4, 4, 4, 4, 4, 4, 1],
	[1, 1, 5, 5, 5, 5, 1, 1, 6, 1, 1, 1, 1, 1, 1, 1, 1, 6, 1, 1, 1, 1, 1, 1, 1, 6, 1, 1, 1, 1, 1, 1, 1, 1, 4, 4, 4, 1, 1, 1],
	[1, 1, 5, 5, 5, 5, 1, 4, 4, 4, 4, 4, 4, 4, 4, 1, 4, 4, 4, 4, 4, 4, 4, 1, 4, 4, 4, 4, 4, 4, 4, 1, 5, 5, 5, 5, 5, 5, 1, 1],
	[1, 1, 5, 5, 5, 5, 1, 4, 4, 4, 4, 4, 4, 4, 4, 1, 4, 4, 4, 4, 4, 4, 4, 1, 4, 4, 4, 4, 4, 4, 4, 1, 5, 5, 4, 4, 5, 5, 1, 1],
	[1, 1, 5, 5, 5, 5, 1, 4, 4, 4, 4, 4, 4,42,43, 1, 4, 4, 4, 4, 4,42,43, 1, 4, 4, 4, 4, 4,42,43, 1, 5, 5, 4, 4, 5, 5, 1, 1],
	[1, 1, 5, 0, 5, 5, 1, 1, 1, 1, 1, 1, 1, 1, 1, 1, 1, 1, 1, 1, 1, 1, 1, 1, 1, 1, 1, 1, 1, 1, 1, 1, 5, 5, 5, 5, 5, 5, 1, 1],
	[1, 1, 0, 5, 5, 5, 5, 5, 5, 5, 5, 5, 5, 5, 5, 5, 5, 5, 5, 5, 5, 5, 5, 5, 5, 5, 5, 5, 5, 5, 5, 5, 5, 4, 4, 5, 5, 5, 1, 1],
	[1, 1, 0, 5, 5, 5, 0, 0, 0, 0, 5, 5, 5, 5, 5, 5, 5, 5, 5, 5, 5, 5, 5, 5, 5, 5, 5, 5, 5, 5, 5, 5, 5, 4, 4, 0, 5, 5, 1, 1],
	[1, 1, 0, 5, 5, 5, 0, 5, 5, 0, 0, 5, 5, 0, 0, 0, 0, 5, 5, 5, 0, 0, 0, 5, 5, 0, 0, 0, 0, 0, 0, 5, 5, 5, 5, 5, 5, 5, 1, 1],
	[1, 1, 0, 5, 5, 5, 0, 5, 5, 5, 0, 5, 5, 5, 5, 5, 5, 5, 5, 5, 5, 5, 5, 5, 5, 5, 5, 5, 5, 5, 5, 5, 5, 5, 5, 5, 5, 0, 1, 1],
	[1, 1, 0, 5, 5, 5, 0, 5, 5, 5, 0, 5, 5, 5, 5, 5, 5, 5, 0, 0, 5, 5, 5, 5, 5, 5,38,39, 0, 5, 4, 4, 5, 5, 5, 5, 5, 0, 1, 1],
	[1, 1, 0, 0, 0, 5, 0, 0, 5, 5, 5, 5, 5, 0, 5, 5, 5, 0, 0, 5, 5, 5, 5, 5, 5, 5,40,41, 5, 5, 4, 4, 5, 5, 5, 5, 5, 5, 1, 1],
	[1, 1, 0, 0, 0, 5, 5, 0, 5, 5, 5, 5, 5, 5, 5, 5, 0, 0, 5, 5, 0, 0, 0, 5, 0, 0, 0, 5, 5, 5, 5, 5, 5, 5, 5, 5, 0, 5, 1, 1],
	[1, 1, 0, 5, 5, 5, 5, 0, 5, 5, 5, 5, 5, 5, 5, 5, 0, 5, 5, 5, 5, 5, 5, 5, 0, 5, 4, 4, 4, 0, 0, 5, 5, 5, 0, 0, 5, 5, 1, 1],
	[1, 1, 0, 0, 0, 0, 5, 5, 5, 5, 5, 5, 5, 5, 5, 0, 5, 5, 5, 5, 5, 5, 0, 5, 5, 5, 4, 4, 4, 5, 5, 5, 5, 5, 5, 5, 5, 5, 1, 1],
	[1, 1, 0, 0, 0, 5, 5, 5, 5, 5, 5, 5, 5, 5, 0, 0, 5, 5, 5, 5, 4, 4, 4, 5, 5, 5, 5, 5, 5, 5, 5, 5, 5, 5, 5, 5, 5, 5, 1, 1],
	[1, 1, 5, 0, 5, 5, 5, 5, 5, 5, 5, 5, 5, 5, 0, 5, 5, 5, 5, 5, 4, 4, 4, 5, 5, 5, 5, 5, 5, 5, 5, 5, 5, 5, 5, 5, 5, 5, 1, 1],
	[1, 1, 5, 0, 5, 5, 0, 5, 5, 5, 5, 5, 5, 0, 5, 5, 5, 4, 4, 5, 0, 5, 5, 5, 5, 5, 0, 0, 0, 0, 5, 5, 5, 5, 5, 0, 5, 5, 1, 1],
	[1, 1, 5, 0, 0, 5, 0, 5, 5, 5, 5, 5, 5, 0, 5, 5, 0, 4, 4, 5, 0, 5, 5, 5, 5, 0, 0, 5, 5, 5, 5, 5, 5, 0, 0, 5, 5, 5, 1, 1],
	[1, 1, 5, 5, 5, 5, 0, 0, 5, 5, 5, 5, 0, 0, 5, 5, 0, 4, 4, 5, 0, 5, 5, 5, 5, 0, 5, 5, 5, 5, 5, 0, 0, 0, 5, 5, 5, 5, 1, 1],
	[1, 1, 5, 5, 5, 5, 5, 0, 5, 5, 5, 0, 0, 5, 5, 5, 0, 5, 5, 0, 5, 5, 5, 5, 5, 0, 5, 5, 5, 0, 0, 0, 5, 5, 5, 5, 5, 5, 1, 1],
	[1, 1, 5, 5, 5, 5, 5, 0, 5, 5, 5, 5, 5, 4, 4, 0, 5, 5, 5, 0, 5, 5, 5, 5, 5, 5, 5, 5, 0, 0, 5, 5, 5, 5, 0, 5, 5, 5, 1, 1],
	[1, 1, 5, 5, 5, 5, 5, 0, 0, 5, 5, 5, 5, 4, 4, 0, 5, 5, 5, 5, 0, 0, 5, 5, 5, 5, 5, 5, 0, 5, 5, 5, 5, 5, 0, 5, 5, 5, 1, 1],
	[1, 1, 5, 5, 5, 5, 5, 5, 0, 5, 5, 5, 5, 4, 4, 0, 5, 5, 5, 5, 5, 0, 0, 0, 5, 5, 5, 5, 0, 5, 5, 5, 5, 5, 5, 5, 5, 5, 1, 1],
	[1, 1, 5, 5, 5, 5, 5, 5, 5, 0, 5, 5, 5, 5, 5, 0, 5, 5, 5, 5, 5, 5, 5, 0, 0, 0, 0, 0, 0, 0, 0, 5, 5, 5, 5, 5, 5, 5, 1, 1],
	[1, 1, 5, 5, 0, 0, 5, 5, 5, 0, 0, 0, 5, 5, 5, 5, 0, 0, 5, 5, 5, 5, 5, 5, 5, 5, 5, 5, 5, 0, 0, 0, 5, 5, 5, 5, 5, 5, 1, 1],
	[1, 1, 5, 5, 0, 0, 0, 5, 5, 5, 5, 5, 4, 4, 5, 5, 0, 0, 5, 5, 5, 5, 5, 5, 5, 5, 5, 5, 5, 0, 0, 0, 5, 5, 5, 5, 0, 5, 1, 1],
	[1, 1, 5, 5, 0, 0, 0, 5, 5, 5, 5, 4, 4, 4, 5, 0, 0, 0, 0, 5, 5, 5, 5, 5, 5, 5, 5, 5, 5, 0, 0, 0, 5, 5, 5, 5, 0, 0, 1, 1],
	[1, 1, 1, 1, 1, 1, 1, 1, 1, 1, 1, 4, 4, 4, 1, 1, 1, 1, 1, 1, 1, 1, 1, 1, 1, 1, 1, 1, 1, 1, 1, 1, 1, 1, 1, 1, 1, 1, 1, 1],
    [1, 1, 1, 1, 1, 1, 1, 1, 1, 1, 1, 4, 4, 4, 1, 1, 1, 1, 1, 1, 1, 1, 1, 1, 1, 1, 1, 1, 1, 1, 1, 1, 1, 1, 1, 1, 1, 1, 1, 1]
]
